0000000000000000000000000000000000000000
0000000000000000000000000000000000000000
0000011110000000000000000000000000000000
@000010010000000000000000000000000000000
111111001000000000000000000000000000000X
0000000011101111111111111111111111111111
0000000000101000000000000000000000000000
0000000000101000000000000000000000000000
0000000000101000000000000000000000000000
0000000000101111111100000000000000000000
0000000000100000000000000000000000000000
0000000000111111111111111111111111111111
0000000000000000000000000000000000000000
0000000000000000000000000000000000000000
0000000000000000000000000000000000000000
0000000000000000000000000000000000000000
0000000000000000000000000000000000000000
0000000000000000000000000000000000000000
0000000000000000000000000000000000000000
0000000000000000000000000000000000000000
0000000000000000000000000000000000000000
0000000000000000000000000000000000000000
0000000000000000000000000000000000000000
0000000000000000000000000000000000000000
0000000000000000000000000000000000000000
0000000000000000000000000000000000000000
0000000000000000000000000000000000000000
0000000000000000000000000000000000000000
0000000000000000000000000000000000000000
0000000000000000000000000000000000000000
0000000000000000000000000000000000000000
0000000000000000000000000000000000000000
ANONYMOUS
CAVE
4
4
4
NONE
2


0