@0L0000000000000001000000000000000000000
11P0000000000000001000000000000000000000
01L000000000000L001000000000000000000000
01L0L0000000011P001000000000000000000000
0111P0000000111L001000000000000000000000
0001L0000000101L001000000000000000000000
0001L00L0001101L0X1000000000000000000000
0001111P00010011111000000000000000000000
0000001L01110000000000000000000000000000
0000001L01000000000000000000000000000000
0000001111000000000000000000000000000000
0000000000000000000000000000000000000000
0000000000000000000000000000000000000000
0000000000000000000000000000000000000000
0000000000000000000000000000000000000000
0000000000000000000000000000000000000000
0000000000000000000000000000000000000000
0000000000000000000000000000000000000000
0000000000000000000000000000000000000000
0000000000000000000000000000000000000000
0000000000000000000000000000000000000000
0000000000000000000000000000000000000000
0000000000000000000000000000000000000000
0000000000000000000000000000000000000000
0000000000000000000000000000000000000000
0000000000000000000000000000000000000000
0000000000000000000000000000000000000000
0000000000000000000000000000000000000000
0000000000000000000000000000000000000000
0000000000000000000000000000000000000000
0000000000000000000000000000000000000000
0000000000000000000000000000000000000000
ANONYMOUS
CAVE
4
4
4
NONE
2


0