0000000L0L000000000100000000000000000000
0000000P1P00000L0LX100000000000000000000
0000000L1L00001P001100000000000000000000
0000000L1L00001L001000000000000000000000
0000000L0L00011L001000000000000000000000
00L00L0P1P00111L001000000000000000000000
00P11P0L1L00111L001000000000000000000000
00L11L0L1L01111L001000000000000000000000
@0L11L0L1L01111L001000000000000000000000
1111111111111111111000000000000000000000
0000000000000000000000000000000000000000
0000000000000000000000000000000000000000
0000000000000000000000000000000000000000
0000000000000000000000000000000000000000
0000000000000000000000000000000000000000
0000000000000000000000000000000000000000
0000000000000000000000000000000000000000
0000000000000000000000000000000000000000
0000000000000000000000000000000000000000
0000000000000000000000000000000000000000
0000000000000000000000000000000000000000
0000000000000000000000000000000000000000
0000000000000000000000000000000000000000
0000000000000000000000000000000000000000
0000000000000000000000000000000000000000
0000000000000000000000000000000000000000
0000000000000000000000000000000000000000
0000000000000000000000000000000000000000
0000000000000000000000000000000000000000
0000000000000000000000000000000000000000
0000000000000000000000000000000000000000
0000000000000000000000000000000000000000
ANONYMOUS
CAVE
4
4
4
NONE
2


0