0000000000000001000000000000000000000000
0000010000000001000000000000000000000000
1111000111001101000000000000000000000000
0000000010000101000000000000000000000000
1111111111111101000000000000000000000000
0000000000000001000000000000000000000000
0000000000000001000000000000000000000000
0001000100000001000000000000000000000000
X000001000111111000000000000000000000000
1100010000000001000000000000000000000000
0100000000000001000000000000000000000000
0110000000000001000000000000000000000000
0111111111111111000000000000000000000000
0000000000000000000000000000000000000000
0000000000000000000000000000000000000000
0000000000000000000000000000000000000000
0000000000000000000000000000000000000000
0000000000000000000000000000000000000000
0000000000000000000000000000000000000000
0000000000000000000000000000000000000000
0000000000000000000000000000000000000000
0000000000000000000000000000000000000000
0000000000000000000000000000000000000000
0000000000000000000000000000000000000000
0000000000000000000000000000000000000000
0000000000000000000000000000000000000000
0000000000000000000000000000000000000000
0000000000000000000000000000000000000000
0000000000000000000000000000000000000000
0000000000000000000000000000000000000000
0000000000000000000000000000000000000000
0000000000000000000000000000000000000000
ANONYMOUS
CAVE
4
4
4
NONE
1

0