0000000000002000000000000000000000000000
2200000000002000000000000000000000000000
0222000000002000000000000000000000000000
00020000000X2000000000000000000000000000
0002220222222222200000000000000000000000
0000000000000000200000000000000000000000
2220222222222022200000000000000000000000
0000000000002000200000000000000000000000
2222222200002000200000000000000000000000
0000000222202222200000000000000000000000
0000000000200000200000000000000000000000
0000000000222222200000000000000000000000
0000000000000000000000000000000000000000
0000000000000000000000000000000000000000
0000000000000000000000000000000000000000
0000000000000000000000000000000000000000
0000000000000000000000000000000000000000
0000000000000000000000000000000000000000
0000000000000000000000000000000000000000
0000000000000000000000000000000000000000
0000000000000000000000000000000000000000
0000000000000000000000000000000000000000
0000000000000000000000000000000000000000
0000000000000000000000000000000000000000
0000000000000000000000000000000000000000
0000000000000000000000000000000000000000
0000000000000000000000000000000000000000
0000000000000000000000000000000000000000
0000000000000000000000000000000000000000
0000000000000000000000000000000000000000
0000000000000000000000000000000000000000
0000000000000000000000000000000000000000
ANONYMOUS
CAVE
4
4
4
NONE
1

0