@000010000000000000000000000000000000000
1111011111100000000000000000000000000000
0000000000100000000000000000000000000000
0111111110100000000000000000000000000000
0000100000100000000000000000000000000000
1111101111111111100000000000000000000000
0000000000000000100000000000000000000000
0111111111111110100000000000000000000000
0000000010000000100000000000000000000000
1110111111101111100000000000000000000000
0000000001X00000100000000000000000000000
1111111111111111100000000000000000000000
0000000000000000000000000000000000000000
0000000000000000000000000000000000000000
0000000000000000000000000000000000000000
0000000000000000000000000000000000000000
0000000000000000000000000000000000000000
0000000000000000000000000000000000000000
0000000000000000000000000000000000000000
0000000000000000000000000000000000000000
0000000000000000000000000000000000000000
0000000000000000000000000000000000000000
0000000000000000000000000000000000000000
0000000000000000000000000000000000000000
0000000000000000000000000000000000000000
0000000000000000000000000000000000000000
0000000000000000000000000000000000000000
0000000000000000000000000000000000000000
0000000000000000000000000000000000000000
0000000000000000000000000000000000000000
0000000000000000000000000000000000000000
0000000000000000000000000000000000000000
ANONYMOUS
CAVE
4
4
4
NONE
2


0