0000001010000000000100000000000000000000
0000000000000000000100000000000000000000
0000000000000000000100000000000000000000
@000L00000000000000100000000000000000000
1111L00000000000000100000000000000000000
X100100000000000000100000000000000000000
1101100000000000000100000000000000000000
0000100000000000000100000000000000000000
0000100000000000000100000000000000000000
0001100000000000000100000000000000000000
0000100000000000000100000000000000000000
0000100000000000000100000000000000000000
0001100000000000000100000000000000000000
0000100000000000000100000000000000000000
0000100000000000000100000000000000000000
0000100000000000000100000000000000000000
0001100000000000000100000000000000000000
0000100000001000000100000000000000000000
0000100000001000000100000000000000000000
0000100000001000000100000000000000000000
0000100000001000000100000000000000000000
0000100000001000000100000000000000000000
0000100000000000000100000000000000000000
0000100000000000000100000000000000000000
0000100000000000000100000000000000000000
0000100000000000000100000000000000000000
0000100000000000000100000000000000000000
0000100000000000000100000000000000000000
0000100000000000000100000000000000000000
0000111111111111111100000000000000000000
0000000000000000000000000000000000000000
0000000000000000000000000000000000000000
ANONYMOUS
CAVE
4
4
4
NONE
2


0