000000000000000000000000000000000000000X
0000000000000111111011111111111111110111
00001111111111L0000000010000001000000000
000010000000L1L1111111110L11101011111110
111110000000L0L0000000000L100010L0000000
000000000000L1L0000000000L101111L0000100
000000111000L1L0000000000L100001L0000101
000001100000L1L00000000011111101L0001100
000001100100L1L00000000010000000L0001110
000011111100L1L000@001111000011111111000
0012222222111111111111111111110000000011
0000100000000000010000000000000000000000
1110100000000000010000000000001111111111
0000100111111111110000001111100000000000
0111101100000000000001111000000111111110
00000000000L0000000000000011111100000000
11111111111P1111110111110011111111111111
00000000000L1L0000010L00000000000000000L
00000000000L1L1222210L11111111111111111L
11101111100L1L1L00000L00000000000000001L
00000000100L1L1L00000L00001001001000111L
1111111011111L1L00000L00001001001000000L
0L00000000000L1L111111111111111111111111
1P11111111111L1L0000L0000000000000000000
0L00010000000L1L0001P1000000000000000000
0L00010000000L1L0111L1110000000000000L00
0L00010000111L0L0100L0011111111111111P11
0L000100001111111100L0000000000000000L00
0L000100111000000000L0000000000200000L00
0L000100001000000000L0000200000200000L00
0L000101101011111100L0002220002220000L00
0L000001100011111100L0022222002220000L00
ANONYMOUS
CAVE
4
4
4
NONE
2


0